F 76,76,78
C 99,99,55

NO srcs/textures/cat.xpm
SO srcs/textures/cat.xpm
WE srcs/textures/cat.xpm
EA srcs/textures/cat.xpm

1111111111
1000000001
11111111111111
111111N0000011
1000000000001
11N111111111111
111111111111111
