F 76,76,78
C 99,99,256

NO srcs/textures/cat.xpm
SO srcs/textures/cat.xpm
WE srcs/textures/cat.xpm
EA srcs/textures/cat.xpm

11111111111111111111111111111111111111111
10010001000000000000001000100000001010011
10000100010001000001100010010111000010111
10101000000100010010010101000000111000001
101011111000011010000001001001100N0011011
10100000011100000101111010001001101001001
11111111111111111111111111111111111111111