F 76,76,78
C 99,99,55,55

NO srcs/textures/cat.xpm
SO srcs/textures/cat.xpm
WE srcs/textures/cat.xpm
EA srcs/textures/cat.xpm

11111111111111111111111111111111111111111111111111
10010001000000000000001000100000001010000100000001
10000100010001000001100010010111000010110000110101
10101000000100010010010101000000111000000101001001
10101111100001101000000100100110000110110100100001
10100000011100000101111010001001101001000010000111
10011110000010010010000000110100000010001001010001
11000001101000100011100010000101000100100101001101
10000010011110010000010001010100110000100000100001
10001100001001001110000101000010001011001011011001
11110010101000100001101001001100010000010000000001
10000010100010001010001000100001001001001111011111
10010000110000010010100100100110001000100000100001
10100111000100100100010001000000100010110010101001
10111000000111000001010010011000100010001100100101
10000111100000011110010001000000011000100010001001
10110000010111000000011100100111000111001000000101
10001001001000101101100010000000100000101001100101
11000100001010010010000101111110101100010010000101
10101010110001001010101000000000110010000010000101
10100010000010001000100011110001000001110001111001
10000100000101001001000100001000101000001010000001
10000010101000101100010100010010100010101010011001
10111010001100100010000001010100100101001000100001
10000001000010011001011110010000100101001001000111
10001110001001000100100001100000010100101101001001
10010000110100100010001100001110000101000001010001
100101010000100001000000001000011110000E1110000101
10100101010000010100011000110100000111110000101001
10101010001011100001000010001010010000001001001001
10100000101000001000101001100011100100100101010001
10100010100100101010101010010100001001000100011001
10100010100110001001001000000101000001011010000001
10001100100001010001010011101001011101000000110001
10010001010010001010010100010010000010111110001111
10001000000001100010101001000010011000000000100001
10001010101100010010000100010000100011001000011101
10100001000010011100010100100100110100000100100001
10010100010001000010010001001001000100110010101001
11000010001110111010001001000001001001001001001111
10101100100000000011100000001001010001010101010001
10000010111110001000000000101001010100000001000101
10010010000001000001011111001000010110100100000101
10010101100100010001000000001000010000011000001001
10010100000000001101110000001110000100100100010001
10010010010111010010000110010001001000000011010101
10100010001000010010101001100100010001010000100101
100001001000101111110010100000010100100100101000101111
10000001000000001000100000000100001000000000001001
11111111111111111111111111111111111111111111111111
