F 255, 87, 51
C 88, 24, 69

NO srcs/textures/obsi.xpm
SO srcs/textures/obsi.xpm
WE srcs/textures/FT_MC.xpm
EA srcs/textures/obsi.xpm

111111111
1S0000001
100000001
101000001
100000001
100000011
100001001
100000001
100000001
11110111
111111111
1111111
111
111111111