

F 220,100,255
C 135,206,255

111111111111111111111111
100000000000000000000001
11111111000000000000000111111111
100000000000000000000001
11111111 111111111111111
100000110100000000001001
100000000111011111111111
100000000000000000000011
100000000000000001000001
100000111110000101010001
100000100010000000000001
100000100010000100010001
100000100010000000000001
1000001101100001010100011111
1000000000000000000E0001
100000000000000000000001
111111000000000000000001111111111
     1111100000000000000000000001
111111000000000000000001111111111
100000000000000000000001
111111111111111111111111