NO srcs/textures/obsi.xpm
SO                        srcs/textures/obsi.xpm
F 20,111,200
C 20,100,1







WE srcs/textures/obsi.xpm
EA srcs/textures/obsi.xpm



11111
10001
10001
10001
1E001    111
10001    101
11001    111
10001
10001
10001
10001
10001
11111