NO srcs/textures/obsi.xpm
SO                        srcs/textures/obsi.xpm
F 20,111,200
C 20,100,12
WE srcs/textures/obsi.xpm
EA srcs/textures/obsi.xpm

         1
         1
    11111111111111111
11111111000000011111
    11110000000001111111
     1110000E000011111         1111111111
1111111000000000000011         111000111
    111111100011111111111        11
         1111111
           1
            1