NO srcs/textures/obsi.xpm
SO srcs/textures/car.xpm
F 20,20,20
C 200,200,200

WE srcs/textures/shronk.xpm
EA srcs/textures/cat.xpm



11111
10001
10001
10001
1E001    111
10001    101
11001    111
10001
10001
10001
10001
10001
11111