NO srcs/textures/wall.xpm
SO srcs/textures/wall.xpm
WE srcs/textures/wall.xpm
EA srcs/textures/wall.xpm

F 220,100,255
C 135,206,255


1111111  111111111111111
100000111100000000001001
100000000111011111111111
100000000000000000000011
100000000000000001000001
100000111110000101010001
100000100010000000000001
100000100010000100010001
100000100010000000000001
100000110110000101010001
100000000000000000000001
10000000000000N000000001
111111000000000000000001111111111

     1111100000000000000000000001
111111000000000000000001111111111
100000000000000000000001
111111111111111111111111
