NO textures/north_wall.xpm
SO textures/south_wall.xpm
WE textures/west_wall.xpm
EA textures/east_wall.xpm

F 220,100,255
C 135,206,255


111111111111111111111111
100000111100000000001001
100000000111011111111111
100000000000000000000011
100000000000000001000001
100000111110000101010001
100000100010000000000001
100000100010000100010001
100000100010000000000001
100000110110000101010001
1000000000000000000000N1
100000000000000000000001
100000000000000000000111
1000000000000000000111
10000000000000000000011
100000000000000000001111
111111111111111111111100





