1111111111
1111000111
1100000001
1111111111
