123456789123
456789122222
11111111111111

54

n