

11111111111111
1111100000W011
1100E000000111
10001111101111
10011111101111
10000000001111
11111111111111

