

11111111111111
11111000000011
1100E000000111
10001111101111
10011111101111
10000000001111
11111111111111

