o1abab12345kkkkkkkkkkkkkkkkkkkkkkkkkkkkkkkkkkkkkkkkkkkkkkkkkkkkkkkkkkkkkkkkkkkkk
t1111000111llllllllllllllllll
1100000001
1111111111
1000000001
1111111111
