1111111111111111111011
101111
110111