0011111111111
1000001111111
1100111000011
1000111000011
1111111111111
