123456789123
456789122222
111111111111
