111111111111111111111
111111111111111101111
